4,3,3,3,3,3,3,3|
4,3,0,0,0,0,2,3|
3,3,0,5,3,3,3,3|
3,0,0,0,0,0,2,3|
3,0,0,5,3,3,3,3|
3,0,0,5,1,0,2,3|
3,0,0,0,0,0,0,3|
3,3,3,3,3,3,3,3