3,3,3,3,3,3,3|
3,0,0,0,0,0,3|
3,3,2,0,5,1,3|
3,0,0,3,3,0,3|
3,3,2,0,5,0,3|
3,0,0,0,0,0,3|
3,3,3,3,3,3,3