4,3,3,3,3,3,4,4,4,4|
4,3,0,0,3,3,3,3,3,4|
4,3,0,0,0,0,0,3,3,4|
3,3,0,3,3,0,0,0,3,4|
3,2,0,2,3,0,1,5,3,3|
3,0,0,0,3,0,5,5,0,3|
3,0,0,2,3,0,0,0,0,3|
3,3,3,3,3,3,3,3,3,3