3,3,3,3,3,3,4|
3,0,0,0,0,3,4|
3,0,2,2,0,3,3|
3,0,3,5,0,0,3|
3,0,1,5,0,0,3|
3,0,0,0,0,0,3|
3,3,3,3,3,3,3