4,4,3,3,3,4,4,4|
4,4,3,2,3,4,4,4|
4,4,3,0,3,3,3,3|
3,3,3,5,0,5,2,3|
3,2,0,5,1,3,3,3|
3,3,3,3,5,3,4,4|
4,4,4,3,2,3,4,4|
4,4,4,3,3,3,4,4